	syll	son	cont	voice	lab	cor	ant	dor	strid	lat	nas	high	low	back	round	long	glot	cons
p	-	-	-	-	+	0	0	0	0	0	-	0	0	0	0	-	0	+
b	-	-	-	+	+	0	0	0	0	0	-	0	0	0	0	-	0	+
t	-	-	-	-	0	+	+	0	-	0	-	0	0	0	0	-	0	+
d	-	-	-	+	0	+	+	0	-	0	-	0	0	0	0	-	0	+
c	-	-	-	-	0	+	-	0	-	0	-	0	0	0	0	-	0	+
ɟ	-	-	-	+	0	+	-	0	-	0	-	0	0	0	0	-	0	+
k	-	-	-	-	0	0	0	+	0	0	-	0	0	0	0	-	0	+
ɡ	-	-	-	+	0	0	0	+	0	0	-	0	0	0	0	-	0	+
f	-	-	+	-	+	0	0	0	0	0	-	0	0	0	0	-	0	+
v	-	-	+	+	+	0	0	0	0	0	-	0	0	0	0	-	0	+
s	-	-	+	-	0	+	+	0	+	0	-	0	0	0	0	-	0	+
z	-	-	+	+	0	+	+	0	+	0	-	0	0	0	0	-	0	+
ʃ	-	-	+	-	0	+	-	0	+	0	-	0	0	0	0	-	0	+
ʒ	-	-	+	+	0	+	-	0	+	0	-	0	0	0	0	-	0	+
h	-	-	+	-	0	0	0	0	0	0	-	0	0	0	0	-	+	+
m	-	+	-	0	+	0	0	0	0	0	+	0	0	0	0	-	0	+
n	-	+	-	0	0	+	+	0	0	0	+	0	0	0	0	-	0	+
ɲ	-	+	-	0	0	+	-	0	0	0	+	0	0	0	0	-	0	+
ʎ	-	+	+	0	0	+	-	0	0	+	-	0	0	0	0	-	0	+
l	-	+	+	0	0	+	+	0	0	+	-	0	0	0	0	-	0	+
r	-	+	+	0	0	+	+	0	0	-	-	0	0	0	0	-	0	+
j	-	+	+	0	0	+	-	0	0	0	-	0	0	0	0	-	0	-
a	+	+	+	0	0	0	0	0	0	0	-	-	+	+	-	-	0	-
e	+	+	+	0	0	0	0	0	0	0	-	-	+	-	-	-	0	-
o	+	+	+	0	0	0	0	0	0	0	-	-	-	+	+	-	0	-
ø	+	+	+	0	0	0	0	0	0	0	-	-	-	-	+	-	0	-
u	+	+	+	0	0	0	0	0	0	0	-	+	-	+	+	-	0	-
y	+	+	+	0	0	0	0	0	0	0	-	+	-	-	+	-	0	-
i	+	+	+	0	0	0	0	0	0	0	-	+	-	-	-	-	0	-
aː	+	+	+	0	0	0	0	0	0	0	-	-	+	+	-	+	0	-
eː	+	+	+	0	0	0	0	0	0	0	-	-	+	-	-	+	0	-
oː	+	+	+	0	0	0	0	0	0	0	-	-	-	+	+	+	0	-
øː	+	+	+	0	0	0	0	0	0	0	-	-	-	-	+	+	0	-
uː	+	+	+	0	0	0	0	0	0	0	-	+	-	+	+	+	0	-
yː	+	+	+	0	0	0	0	0	0	0	-	+	-	-	+	+	0	-
iː	+	+	+	0	0	0	0	0	0	0	-	+	-	-	-	+	0	-
ɯ	+	+	+	0	0	0	0	0	0	0	-	+	-	+	-	-	0	-
ɯː	+	+	+	0	0	0	0	0	0	0	-	+	-	+	-	+	0	-
tʃ	-	-	-	-	0	+	-	0	+	0	-	0	0	0	0	-	0	+
dʒ	-	-	-	+	0	+	-	0	+	0	-	0	0	0	0	-	0	+
